11111111111111111111
1000000000000000C001
10000000000000000001
10000000000000000001
100000000P0000000001
10000000000000000001
10000000000000000001
100C0000000000000001
100000000000000000E1
11111111111111111111