11111111111111111111111111
10000000C000000P000000C001
10000000000000000000000001
10111000111001111111111001
10111000111001110000111001
10111111111001100000111001
10000000111000000001110001
10000000111000000011100001
100C0000111000000111000C01
1E000000111000011110000001
10000000111001111111111101
10000000000000000000000001
11111111111111111111111111