11111111111111111111
1000C010001101100001
10001100000000000001
1000C100000011110101
101111010P0100001101
10010000000000110001
10000110000000000001
10001111000000000001
100000000000C00000E1
11111111111111111111