1111111111
10100C1101
1111P00111
10010100E1
1111111111