1111111111
10100C1001
1111P00011
1C010100E1
1111111111