1111111111
101C0010C1
1011P0C011
1C000100E1
1111111111