1111111111111
1C11C10C000C1
1001000001111
1C0001C000PE1
1111111111111