1111111111111
11C1C10000011
110100C001E11
1P000100C1111
1111111111111